0,1
3599975,0
3599988,1
7591153,0
7591166,1
11582105,0
11582118,1
15573065,0
15573078,1
19564090,0
19564103,1
23555299,0
23555312,1
27546424,0
27546437,1
31537411,0
31537424,1
35528452,0
35528465,1
39519562,0
39519575,1
43510760,0
43510773,1
47502172,0
47502185,1
51493323,0
51493335,1
55484539,0
55484552,1
59475421,0
59475434,1
63466360,0
63466373,1
67457401,0
67457414,1
